­ЪЌЙ жЃйжЂЊт║юуюїсЃГсЃ╝сЃътГЌт»Йт┐юУАе№╝ѕURLсЃ╗сЃЋсѓАсѓцсЃФтљЇуће№╝Ѕ
ТЌЦТюгУфъ	сЃГсЃ╝сЃътГЌУАеУеў
тїЌТхижЂЊ	hokkaido
жЮњТБ«уюї	aomori
т▓ЕТЅІуюї	iwate
т««тЪјуюї	miyagi
уДІућ░уюї	akita
т▒▒тйбуюї	yamagata
удЈт│Хуюї	fukushima
УїетЪјуюї	ibaraki
ТаЃТюеуюї	tochigi
уЙцждгуюї	gunma
тЪ╝ујЅуюї	saitama
тЇЃУЉЅуюї	chiba
ТЮ▒С║гжЃй	tokyo
уЦътЦѕтиЮуюї	kanagawa
Тќ░ТйЪуюї	niigata
т»їт▒▒уюї	toyama
уЪ│тиЮуюї	ishikawa
удЈС║Ћуюї	fukui
т▒▒Тбеуюї	yamanashi
жЋижЄјуюї	nagano
т▓љжўюуюї	gifu
жЮЎт▓Ауюї	shizuoka
ТёЏуЪЦуюї	aichi
СИЅжЄЇуюї	mie
Т╗ІУ│ђуюї	shiga
С║гжЃйт║ю	kyoto
тцДжўфт║ю	osaka
тЁхт║Фуюї	hyogo
тЦѕУЅ»уюї	nara
тњїТГїт▒▒уюї	wakayama
ж│ЦтЈќуюї	tottori
т│ХТа╣уюї	shimane
т▓Ат▒▒уюї	okayama
т║Ѓт│Хуюї	hiroshima
т▒▒тЈБуюї	yamaguchi
тЙ│т│Хуюї	tokushima
ждЎтиЮуюї	kagawa
ТёЏтфЏуюї	ehime
жФўуЪЦуюї	kochi
удЈт▓Ауюї	fukuoka
СйљУ│ђуюї	saga
жЋит┤јуюї	nagasaki
уєіТюгуюї	kumamoto
тцДтѕєуюї	oita
т««т┤јуюї	miyazaki
ж╣┐тЁљт│Хуюї	kagoshima
Т▓ќуИёуюї	okinawa
